{
  "id": "map1",
  "name": "Classic Grid",
  "width": 15,
  "height": 13,
  "grid": [
    "###############",
    "#.............#",
    "#.#.#.#.#.#.#.#",
    "#.............#",
    "#.#.#.#.#.#.#.#",
    "#.............#",
    "#.#.#.#.#.#.#.#",
    "#.............#",
    "#.#.#.#.#.#.#.#",
    "#.............#",
    "#.#.#.#.#.#.#.#",
    "#.............#",
    "###############"
  ],
  "spawnPoints": [
    { "x": 1, "y": 1 },
    { "x": 13, "y": 1 },
    { "x": 1, "y": 11 },
    { "x": 13, "y": 11 },
    { "x": 1, "y": 6 },
    { "x": 13, "y": 6 }
  ]
}
