{
  "id": "map3",
  "name": "Grand Classic",
  "width": 21,
  "height": 15,
  "grid": [
    "#####################",
    "#...................#",
    "#.#.#.#.#.#.#.#.#.#.#",
    "#...................#",
    "#.#.#.#.#.#.#.#.#.#.#",
    "#...................#",
    "#.#.#.#.#.#.#.#.#.#.#",
    "#...................#",
    "#.#.#.#.#.#.#.#.#.#.#",
    "#...................#",
    "#.#.#.#.#.#.#.#.#.#.#",
    "#...................#",
    "#.#.#.#.#.#.#.#.#.#.#",
    "#...................#",
    "#####################"
  ],
  "spawnPoints": [
    { "x": 1, "y": 1 },
    { "x": 19, "y": 1 },
    { "x": 1, "y": 13 },
    { "x": 19, "y": 13 },
    { "x": 1, "y": 7 },
    { "x": 19, "y": 7 }
  ]
}
