{
  "id": "map4",
  "name": "Canyon",
  "width": 19,
  "height": 15,
  "grid": [
    "###################",
    "#.....#.....#.....#",
    "#.###.#.#.#.#.###.#",
    "#.#...#.#.#.#...#.#",
    "#.#.#...#.#...#.#.#",
    "#.#.#.###.###.#.#.#",
    "#...#.#.....#.#...#",
    "#.#.#.#.###.#.#.#.#",
    "#...#.#.....#.#...#",
    "#.#.#.###.###.#.#.#",
    "#.#.#...#.#...#.#.#",
    "#.#...#.#.#.#...#.#",
    "#.###.#.#.#.#.###.#",
    "#.....#.....#.....#",
    "###################"
  ],
  "spawnPoints": [
    { "x": 1, "y": 1 },
    { "x": 17, "y": 1 },
    { "x": 1, "y": 13 },
    { "x": 17, "y": 13 },
    { "x": 1, "y": 7 },
    { "x": 17, "y": 7 }
  ]
}
