{
  "id": "map5",
  "name": "Titan Fields",
  "width": 23,
  "height": 17,
  "grid": [
    "#######################",
    "#.....................#",
    "#.#.#.#.#.#.#.#.#.#.#.#",
    "#.....................#",
    "#.#.#.#.#.#.#.#.#.#.#.#",
    "#.....................#",
    "#.#.#.#.#.#.#.#.#.#.#.#",
    "#.....................#",
    "#.#.#.#.#.#.#.#.#.#.#.#",
    "#.....................#",
    "#.#.#.#.#.#.#.#.#.#.#.#",
    "#.....................#",
    "#.#.#.#.#.#.#.#.#.#.#.#",
    "#.....................#",
    "#.#.#.#.#.#.#.#.#.#.#.#",
    "#.....................#",
    "#######################"
  ],
  "spawnPoints": [
    { "x": 1, "y": 1 },
    { "x": 21, "y": 1 },
    { "x": 1, "y": 15 },
    { "x": 21, "y": 15 },
    { "x": 1, "y": 8 },
    { "x": 21, "y": 8 }
  ]
}
